###############
#1    // /   2#
# # # # # # # #
# / /    / /  #
# # # # # # # #
#   ///     //#
# # # #/#/#/# #
#//  //  //  /#
# # # # #/# # #
#  /        //#
# # # # # # # #
# ///      /  #
# # # # # # # #
#   // /  /   #
###############