###############
#1           2#
# # # # # # # #
#             #
# # # # # # # #
#             #
# # # # # # # #
#             #
# # # # # # # #
#             #
# # # # # # # #
#             #
# # # # # # # #
#             #
###############