---------------
-             -
- - - - - - - -
-             -
- - - - - - - -
-             -
- - - - - - - -
-             -
- - - - - - - -
-             -
- - - - - - - -
-             -
- - - - - - - -
-             -
---------------