###############
#1           2#
# # # # # # # #
# / /         #
# # # # # # # #
#             #
# # # #/#/# # #
#             #
# # # # # # # #
#             #
# # # # # # # #
#             #
# # # # # # # #
#             #
###############