---------------
-P           P-
- - - - - - - -
-             -
- - - - - - - -
-             -
- - - - - - - -
-             -
- - - - - - - -
-             -
- - - - - - - -
-             -
- - - - - - - -
-P           P-
---------------